1,0,0,9,0,7,8,5,5
5,5,0,7,0,5,0,5,5
5,5,0,5,0,9,0,0,4
3,0,0,5,0,0,0,5,5
7,5,5,3,5,5,5,5,5
5,8,0,5,0,0,0,0,5
0,2,0,5,0,5,5,5,5
0,0,0,5,0,0,5,0,0
2,8,5,5,0,5,5,4,6